1 10 10
##########
#x      p#
#  +++   #
#  +x+   #
#  +++   #
#       ##
#  #### ##
#  # x  ##
#  # #####
##########