1 13 31
###############################
#p     ** *  1 * 2 *  * * *   #
#x# # #*# # #*#*# # # #*#*#*# #
#x x*     ***  *  1   * 2 * * #
#x# # # # #*# # #*#*# # # # #*#
#f         x **  *  *   1     #
#x# # # # # # # # #*# #*# # # #
#*  *      *  *      *        #
#x# # # #*# # # #*#*# # # # # #
#*    **  *       *           #
#x#*# # # # # # #*# # # # # # #
#*          *   *  *          #
###############################