1 15 21
#####################
#p   + f   +        #
#+# #+#x#+#x# #+#+# #
#+ b x + + s + + b  #
# #x#+#+#+# # # # #+#
#+ + x+b     + x +  #
#    +     + x +   +#
#x +#+  +++ # # #x# #
#  f x  x+ +    ++  #
# #+# # #+#+# # # # #
#x s#b   + + +   + +#
# #+  #x#+#S#+# ++# #
#  x + +   x +     +#
#x  #+#?#+    # #+#+#
#####################