1 10 10
##########
#       p#
#  # #   #
#  # #   #
#x       #
#     # ##
#  #### ##
#  #    ##
#  # #####
##########