1 10 7
#######
#p    #
#     #
#     #
#     #
#     #
#     #
#     #
#    x#
#######