1 10 10
##########
#      xp#
#  # #  x#
#  # #   #
#x       #
#     # ##
#  #### ##
#  #    ##
#  # #####
##########