1 9 12
############
#       pS #
#  sfs  ss #
#  sxs  fs #
#  +++  bs #
#       ?###
#  ####   ##
#  #      ##
############