1 9 12
############
#x      p  #
#  +++     #
#  +x+     #
#  +++     #
#        ###
#  ####   ##
#  # x    ##
############