1 13 31
###############################
#p     ** *  1 * 2 *  * * *   #
#x# # #*# # #*#*# # # #*#*#*# #
#  x*     ***  *  1   * 2 * * #
#x# # # # #*# # #*#*# # # # #*#
#          x **  *  *   1     #
#x# # # # # # # # #*# #*# # # #
#   *      *  *      *        #
#x# # # #*# # # #*#*# # # # # #
#     **  *       *           #
#x#*# # # # # # #*# # # # # # #
#           *   *  *          #
###############################