1 10 10
##########
#p       #
#    x   #
#      x #
#  x     #
#   x    #
#x    x  #
#  x     #
#    x   #
##########